NO textures/greystone.xpm
SO textures/bluestone.xpm
WE textures/colorstone.xpm
EA textures/purplestone.xpm

F 164,169,20
C 153,204,255

1111
11S1
1111
1111
