NO textures/greystone.xpm
SO textures/bluestone.xpm
WE textures/colorstone.xpm
EA textures/purplestone.xpm

F 159,200,68
C 20,150,200

1111
11S1
1111
1111
