NO textures/bluestone.xpm
SO textures/colorstone.xpm
WE textures/mossy.xpm
EA textures/purplestone.xpm

F 18,53,25
C 153,204,255

111111111111
1000         11
1          1
111111111111
10S000000001
111111111111
11         1
111111111111
